*********
*       *
*   *****
*   *   *
*  ******
*      **
**  *S  *
*   *   E
*********
