*E*******
*       *
*   *****
*   *   *
*   *****
*       *
**  S   *
*       *
*********
